1111111111111111111111111111111111
1E0000000000000CT0000C000000000001
1010010100100000101001000000010101
10100100101010100010010000000101T1
1P0000000CT0C0000000000000000000C1
1111111111111111111111111111111111