11111111111111111111111
1C000000000000100000001
10T0000000000000000C001
1101110000111100CT00001
1E000000001111000000001
1111111100011100P000001
10000000000001000000001
10CT000000000100000T001
11T1110000111100000C001
10000000000C00000000001
11111111111111111111111