1111111111111111111111111111111111111111
10010000000C011110001111111C111111111111
1000C11111000000000000000000000000011111
1P0011C000000C01000011111001111111100001
10000111110000011000111110000111111C0001
1000011111000001110000000000011111100C01
1000011111000001111111100011111111C000C1
100011E0000000C1111111C000011111111111C1
10000111110000011100000111111111110C00C1
101111C00000000111C00000000000000000C0C1
1000C0011100000000C111111111111111C00011
10000111110000011100000111111111110C00C1
101111C00000000111C00000000000000000C0C1
1000C0011100000000C111111111111111C00011
10000111110000011100000111111111110C00C1
101111C00000000111C00000000000000000C0C1
101111C00000000111C00000000000000000C0C1
1000C0011100000000C111111111111111C00011
10000111110000011100000111111111110C00C1
101111C00000000111C00000000000000000C0C1
1000C0011100000000C111111111111111C00011
1111111111111111111111111111111111111111