111111111111111111111111111111111111111111111111111111111111
10010000000C011111111111011111111111111111111111111111111111
101111C000000000000000000000000C0000000000000000000000000001
1000C1111100000000000000001111111111111111111111111111111111
100011C000000C01000000000000000000C0000000000000000000000001
100001111100000110001111100001111110111111111111111111111111
100011E0000000C1111111C0111111111110111111111111111111111111
101111C000000000000000000000000C0000000000000000000000000001
101111C00000000111C000000000000000C0111111111111111111111111
101111C000000000000000000000000C0000000000000000000000000001
1000C0011100000000C11111111111111101111111111111111111111111
10010000000C000000000000C00000000000000000000000000000000001
1000C0000000000000000000000000000000000000000000000000000001
100011C000000C01000000000000000000C0000000000000000000000001
100001111100000111000000000001111110111111111111111111111111
10000000000000000000000000000000001C000000000000000000000001
1000011111000001111111100011111111CC000000000000000000000001
1000011111000000000000000000000C0000000000000000000000000001
101111C000000000000000000000000C0000000000000000000000000001
1000C0011100000000C000000000000000C0000000000000000000000001
1000011111000001110000011111111111C0111111111111111111111111
10010000000C000000000000C00000000000000000000000000000000001
1000C0000000000000000000000000000000000000000000000000000001
1000011111000001111111100011111111C0111111111111111111111111
1P0011C000000C01000000000000000000C0000000000000000000000001
10000000000000011000000000000111111C000000000000000000000001
10000000000000000000000000000000001C000000000000000000000001
1000011111000001111111100011111111CC000000000000000000000001
1000011111000001111111100011111111C0111111111111111111111111
1000011111000000000000000000000C0000000000000000000000000001
101111C000000000000000000000000C0000000000000000000000000001
1000C0011100000000C000000000000000C0000000000000000000000001
111111111111111111111111111111111111111111111111111111111111