111111111111
100100000001
100001111101
1P0011000001
1E00C1111101
100111110001
100001111101
101111100001
111111111111