11111111111111111111111
1C000000000000100000001
1000000000000000000C001
1101110000111100C000001
1E000000001111000000001
1110011100111100P000001
10000000000001000000001
10C00000000001000000001
1111110000111100000C001
10000000000C00000000001
11111111111111111111111