111111111111111111111111111111111111111111111111111111111111
100000000000000000000000000000000000000000000000000000000001
100000000000000000000000000000000000000000000000000000000001
100000000000000000000000000000000000000000000000000000000001
100001111100111111000000010000001111110001000010011111100001
100001000000100001000000010000001000010001100010010000000001
100001000000100001000000010000001000010001110010010000000001
100001111100100001001110010000001000010001011010010001100001
100000000100100001000P00010000001000010001001110010000100001
100000000100100001000000010000001000010001000110010000100001
100001111100111111000000011111001111110001000010011111100001
100000000000000000000000000000000000000000000000000000000001
100000000000000000000000000000000000000000000000000000000001
100000000000000000000000000000000000000000000000000000000001
100000000000000000000000000000000000000000000000000000000001
100000000000000000000000000000000000000000000000000000000001
100000000000000000000000000000000000000000000000000000000001
100000000000000000000000000000000000000000000000000000000001
100000000000000000000011110000000111100000000000000000000001
100000000000000000000011110000000111100000000000000000000001
100000000000000000000011110000000111100000000000000000000001
10000000000000000000001111000E000111100000000000000000000001
100000000000000000000000000000000000000000000000000000000001
100000000000000000000000000000000000000000000000000000000001
100000000000000000000000000000000000000000000000000000000001
1000000000000000000111CC00CC00CC00CC001110000000000000000001
100000000000000000011100CC00CC00CC00CC1110000000000000000001
10000000000000000000111C00CC00CC00CC011100000000000000000001
100000000000000000000111111111111111111000000000000000000001
100000000000000000000011111111111111110000000000000000000001
100000000000000000000000000000000000000000000000000000000001
100000000000000000000000000000000000000000000000000000000001
111111111111111111111111111111111111111111111111111111111111