1111111111111
10010000000C1
1000011111T01
1P001CEC00001
1111111111111