1111111111111111111111111111111111111111111111111111111111111
1000000000000000000000000000000000000000000000000000000000011
1000000000000000000000000000000000000000000000000000000000011
1000000000000000000000000000000000000000000000000000000000011
1000011111001111110000000100000011111100010000100111111000011
1000010000001000010000000100000010000100011000100100000000011
1000010000001000010000000100000010000100011100100100000000011
1000011111001000010011100100000010000100010110100100011000011
100000000100100001000P000100000010000100010011100100001000011
1000000001001000010000000100000010000100010001100100001000011
1000011111001111110000000111110011111100010000100111111000011
1000000000000000000000000000000000000000000000000000000000011
1000000000000000000000000000000000000000000000000000000000011
1000000000000000000000000000000000000000000000000000000000011
1000000000000000000000000000000000000000000000000000000000011
1000000000000000000000000000000000000000000000000000000000011
1000000000000000000000000000000000000000000000000000000000011
1000000000000000000000000000000000000000000000000000000000011
1000000000000000000111100000001111000000000000000000000000011
1000000000000000000111100000001111000000000000000000000000011
1000000000000000000111100000001111000000000000000000000000011
10000000000000000001111000E0001111000000000000000000000000011
1000000000000000000000000000000000000000000000000000000000011
1000000000000000000000000000000000000000000000000000000000011
1000000000000000000000000000000000000000000000000000000000011
1000000000000000111CCCCCCCCCCCCCCC111000000000000000000000011
1000000000000000111CCCCCCCCCCCCCCC111000000000000000000000011
10000000000000000111CCCCCCCCCCCCC1110000000000000000000000011
1000000000000000001111111111111111100000000000000000000000011
1000000000000000000111111111111111000000000000000000000000011
1000000000000000000000000000000000000000000000000000000000011
1000000000000000000000000000000000000000000000000000000000011
1000000000000000000000000000000000000000000000000000000000011
1111111111111111111111111111111111111111111111111111111111111